{
  "name": "hotdox76-v2",
  "vendorProductId": 2862000809,
  "macros": ["", "", "", "", "", "", "", "", "", "", "", "", "", "", "", ""],
  "layers": [
    [
      "KC_NO",
      "KC_LCTL",
      "KC_TAB",
      "KC_SPC",
      "KC_END",
      "MO(1)",
      "KC_HOME",
      "KC_LGUI",
      "KC_GRV",
      "KC_MENU",
      "KC_PSCR",
      "KC_LALT",
      "KC_NO",
      "KC_NO",
      "KC_BSLS",
      "KC_SCLN",
      "KC_Q",
      "KC_J",
      "KC_K",
      "KC_X",
      "KC_LBRC",
      "KC_LSFT",
      "KC_A",
      "KC_O",
      "KC_E",
      "KC_U",
      "KC_I",
      "KC_NO",
      "KC_TAB",
      "KC_QUOT",
      "KC_COMM",
      "KC_DOT",
      "KC_P",
      "KC_Y",
      "KC_BSPC",
      "KC_ESC",
      "KC_1",
      "KC_2",
      "KC_3",
      "KC_4",
      "KC_5",
      "KC_NO",
      "KC_NO",
      "KC_RGUI",
      "KC_BSPC",
      "KC_ENT",
      "KC_PGDN",
      "KC_RCTL",
      "KC_PGUP",
      "KC_RGHT",
      "KC_DOWN",
      "KC_UP",
      "KC_LEFT",
      "KC_RALT",
      "KC_NO",
      "KC_NO",
      "KC_MINS",
      "KC_Z",
      "KC_V",
      "KC_W",
      "KC_M",
      "KC_B",
      "KC_RBRC",
      "KC_RSFT",
      "KC_S",
      "KC_N",
      "KC_T",
      "KC_H",
      "KC_D",
      "KC_NO",
      "KC_EQL",
      "KC_L",
      "KC_R",
      "KC_C",
      "KC_G",
      "KC_F",
      "KC_DEL",
      "KC_SLSH",
      "KC_0",
      "KC_9",
      "KC_8",
      "KC_7",
      "KC_6",
      "KC_INS"
    ],
    [
      "KC_NO",
      "KC_TRNS",
      "KC_TRNS",
      "KC_TRNS",
      "KC_TRNS",
      "KC_TRNS",
      "KC_TRNS",
      "KC_TRNS",
      "KC_TRNS",
      "KC_PAUS",
      "KC_TRNS",
      "KC_TRNS",
      "KC_NO",
      "KC_NO",
      "KC_TRNS",
      "KC_TRNS",
      "KC_TRNS",
      "KC_TRNS",
      "KC_TRNS",
      "KC_TRNS",
      "KC_TRNS",
      "KC_TRNS",
      "KC_TRNS",
      "KC_TRNS",
      "KC_TRNS",
      "KC_TRNS",
      "KC_TRNS",
      "KC_NO",
      "KC_TRNS",
      "KC_TRNS",
      "KC_TRNS",
      "KC_TRNS",
      "KC_TRNS",
      "KC_TRNS",
      "KC_TRNS",
      "RESET",
      "KC_F1",
      "KC_F2",
      "KC_F3",
      "KC_F4",
      "KC_F5",
      "KC_F6",
      "KC_NO",
      "KC_TRNS",
      "KC_TRNS",
      "KC_TRNS",
      "KC_TRNS",
      "KC_TRNS",
      "KC_TRNS",
      "KC_PEQL",
      "KC_PDOT",
      "KC_P0",
      "KC_TRNS",
      "KC_TRNS",
      "KC_NO",
      "KC_NO",
      "KC_PSLS",
      "KC_P3",
      "KC_P2",
      "KC_P1",
      "KC_TRNS",
      "KC_TRNS",
      "KC_TRNS",
      "S(KC_8)",
      "KC_P6",
      "KC_P5",
      "KC_P4",
      "KC_TRNS",
      "KC_TRNS",
      "KC_NO",
      "S(KC_EQL)",
      "KC_P9",
      "KC_P8",
      "KC_P7",
      "KC_TRNS",
      "KC_TRNS",
      "KC_TRNS",
      "S(KC_MINS)",
      "KC_F12",
      "KC_F11",
      "KC_F10",
      "KC_F9",
      "KC_F8",
      "KC_F7"
    ],
    [
      "KC_NO",
      "KC_TRNS",
      "KC_TRNS",
      "KC_TRNS",
      "KC_TRNS",
      "KC_TRNS",
      "KC_TRNS",
      "KC_TRNS",
      "KC_TRNS",
      "KC_TRNS",
      "KC_MS_BTN1",
      "KC_MS_BTN2",
      "KC_NO",
      "KC_NO",
      "KC_TRNS",
      "KC_TRNS",
      "KC_TRNS",
      "KC_TRNS",
      "KC_TRNS",
      "KC_TRNS",
      "KC_TRNS",
      "KC_TRNS",
      "KC_TRNS",
      "KC_TRNS",
      "KC_TRNS",
      "KC_TRNS",
      "KC_TRNS",
      "KC_NO",
      "KC_TRNS",
      "KC_TRNS",
      "KC_TRNS",
      "KC_TRNS",
      "KC_TRNS",
      "KC_TRNS",
      "KC_TRNS",
      "KC_TRNS",
      "KC_TRNS",
      "KC_TRNS",
      "KC_TRNS",
      "KC_TRNS",
      "KC_TRNS",
      "KC_TRNS",
      "KC_NO",
      "KC_TRNS",
      "KC_TRNS",
      "KC_WWW_BACK",
      "KC_TRNS",
      "KC_TRNS",
      "KC_TRNS",
      "KC_TRNS",
      "KC_TRNS",
      "KC_MUTE",
      "KC_VOLD",
      "KC_VOLU",
      "KC_NO",
      "KC_NO",
      "KC_TRNS",
      "KC_TRNS",
      "KC_MNXT",
      "KC_MPRV",
      "KC_TRNS",
      "KC_TRNS",
      "KC_TRNS",
      "KC_MPLY",
      "KC_TRNS",
      "KC_TRNS",
      "KC_TRNS",
      "KC_TRNS",
      "KC_TRNS",
      "KC_NO",
      "KC_TRNS",
      "KC_TRNS",
      "KC_TRNS",
      "KC_TRNS",
      "KC_TRNS",
      "KC_TRNS",
      "KC_TRNS",
      "KC_TRNS",
      "KC_TRNS",
      "KC_TRNS",
      "KC_TRNS",
      "KC_TRNS",
      "KC_TRNS",
      "KC_TRNS"
    ],
    [
      "KC_NO",
      "KC_TRNS",
      "KC_TRNS",
      "KC_TRNS",
      "KC_TRNS",
      "KC_TRNS",
      "KC_TRNS",
      "KC_TRNS",
      "KC_TRNS",
      "KC_TRNS",
      "KC_TRNS",
      "KC_TRNS",
      "KC_NO",
      "KC_NO",
      "KC_TRNS",
      "KC_TRNS",
      "KC_TRNS",
      "KC_TRNS",
      "KC_TRNS",
      "KC_TRNS",
      "KC_TRNS",
      "KC_TRNS",
      "KC_TRNS",
      "KC_TRNS",
      "KC_TRNS",
      "KC_TRNS",
      "KC_TRNS",
      "KC_NO",
      "KC_TRNS",
      "KC_TRNS",
      "KC_TRNS",
      "KC_TRNS",
      "KC_TRNS",
      "KC_TRNS",
      "KC_TRNS",
      "KC_TRNS",
      "KC_TRNS",
      "KC_TRNS",
      "KC_TRNS",
      "KC_TRNS",
      "KC_TRNS",
      "KC_TRNS",
      "KC_NO",
      "KC_TRNS",
      "KC_TRNS",
      "KC_TRNS",
      "KC_TRNS",
      "KC_TRNS",
      "KC_TRNS",
      "KC_TRNS",
      "KC_TRNS",
      "KC_TRNS",
      "KC_TRNS",
      "KC_TRNS",
      "KC_NO",
      "KC_NO",
      "KC_TRNS",
      "KC_TRNS",
      "KC_TRNS",
      "KC_TRNS",
      "KC_TRNS",
      "KC_TRNS",
      "KC_TRNS",
      "KC_TRNS",
      "KC_TRNS",
      "KC_TRNS",
      "KC_TRNS",
      "KC_TRNS",
      "KC_TRNS",
      "KC_NO",
      "KC_TRNS",
      "KC_TRNS",
      "KC_TRNS",
      "KC_TRNS",
      "KC_TRNS",
      "KC_TRNS",
      "KC_TRNS",
      "KC_TRNS",
      "KC_TRNS",
      "KC_TRNS",
      "KC_TRNS",
      "KC_TRNS",
      "KC_TRNS",
      "KC_TRNS"
    ]
  ],
  "encoders": []
}